敌砖空空砖空空砖空敌砖空敌
空砖空空砖空空砖空空砖空空
空砖空空砖空空砖空空砖空空
空砖空空砖空空砖空空砖空砖
空砖草草草空砖砖砖空砖空砖
空空草空空空空空草草草空砖
空空草水水水空空水水水空砖
空砖空空空砖空空空砖空空砖
空砖水水水砖水水水砖空空砖
空砖空空空砖空空空砖空草草
空砖空铁空铁铁空空铁空草草
空空空空空空空空空空空空空
空空空空空空空空空空空空空